00000000000000000000
00000000000000000000
00000000000000000000
00000000000000000000
00000000000000000000
13333333333333333111
00000000003000000000
00000000003000000000
00000000003000000000
00000000003000000000
00000000003000000000
00000000003000000000
00000000003000000000
00000000003300000000
00000000000333000000
00000000000003200000
00000000000000000000
00000000000000000000
00000000000000000000
00000000000000000000
