00000000000000000000
00000000000000000000
00000000000000000000
00000000000000000000
11311111111111111111
00000000000000000001
00000000000000000011
00000000000000000010
00000000000000011110
00000000000000002000
00000000000000000000
00000000000000000000
00000000000000000000
00000000000000000000
00000000000000000000
00000000000000000000
00000000000000000000
00000000000000000000
00000000000000000000
00000000000000000000
