11111111111111000000
00000000000001000000
00000000000001000000
00000000000001000000
00000000000001000000
00000000000001000000
00000000000001000000
00000000000001000000
00000000000001000000
00000000000001111112
00000000000000000000
00000000000000000000
00000000000000000000
00000000000000000000
00000000000000000000
00000000000000000000
00000000000000000000
00000000000000000000
00000000000000000000
00000000000000000000
